{
  "0": "슬픔",
  "1": "기쁨",
  "2": "분노",
  "3": "불안",
  "4": "당황",
  "5": "상처",
  "6": "중립"
}